20 20
100 100
8 3 3 3 3 3 3 3 3 3 3 3 3 3 3 3 3 3 3 6
5 9 7 7 7 7 7 7 7 7 7 7 7 7 7 7 7 7 2 4
5 10 0 0 0 0 0 0 0 0 0 0 0 0 0 0 0 0 1 4
5 10 0 0 0 0 0 0 0 0 0 0 0 0 0 0 0 0 1 4
5 10 0 0 0 0 0 0 0 0 0 0 0 0 0 0 0 0 1 4
5 10 0 0 0 0 0 3 13 13 13 13 13 13 0 0 0 0 1 4
5 10 0 0 0 0 0 3 9 7 7 7 7 7 0 0 0 0 1 4
5 10 0 0 0 0 0 3 10 0 0 0 0 0 0 0 0 0 1 4
5 10 0 0 0 0 0 3 10 0 0 0 0 0 0 0 0 0 1 4
5 3  13 13 13 13 13 13 10 0 0 0 0 0 0 0 0 0 1 4
5 9  7 7 7 7 7 7 0  0 0 0 0 0 0 0 0 0 1 4
5 10 0 0 0 0 0 0 0  0 0 0 0 0 0 0 0 0 1 4
5 10 0 0 0 0 0 0 0  3 13 13 13 13 0 0 13 13 13 4
5 10 0 0 0 0 0 0 0  3 9 7 7 7 0 0 7 7 2 4
5 10 0 0 0 0 0 0 0 3 10 0 0 0 0 0 0 0 1 4
5 10 0 0 0 0 0 0 0 3 10 0 0 0 0 0 0 0 1 4
5 10 0 0 0 0 0 0 0 3 10 0 0 0 0 0 0 0 1 4
5 10 0 0 0 0 0 0 0 3 10 0 0 0 0 0 0 0 1 4
5 10 0 0 0 0 0 0 0 3 10 0 0 0 0 0 0 0 1 4
12 15 13 13 13 13 13 13 13 13 13 13 13 13 13 13 13 13 14 11